,component,x_max,x_min,y_max,y_min,height,width
0,div,197,170,327,192,27,135
1,div,197,170,396,337,27,59
2,div,197,170,482,406,27,76
3,div,197,170,563,492,27,71
4,div,197,170,630,573,27,57
5,div,197,170,701,640,27,61
6,div,197,170,761,711,27,50
7,div,197,170,834,771,27,63
8,div,236,209,277,192,27,85
9,img,84,0,556,193,84,363
10,img,84,0,738,558,84,180
11,img,84,0,920,740,84,180
