,component,x_max,x_min,y_max,y_min,height,width
0,div,614,43,1058,710,571,348
1,div,231,198,1016,752,33,264
2,div,322,283,1018,750,39,268
3,div,366,327,1018,750,39,268
4,div,410,371,1018,750,39,268
5,div,454,415,1018,750,39,268
6,div,500,469,1016,752,31,264
7,div,694,625,1058,710,69,348
8,div,793,752,881,745,41,136
9,div,793,752,1023,889,41,134
